Job ID,Arrival,Burst,Priority,Deadline,Start,End,Turn Around
0,0,76,1,3,0,76,76
1,1,42,1,10,76,118,117
2,1,96,1,19,118,214,213
3,1,84,2,7,214,298,297
4,1,72,1,2,298,370,369
5,2,36,3,21,370,406,404
6,2,46,3,4,406,452,450
7,3,46,1,13,452,498,495
8,3,35,3,7,498,533,530
9,3,65,1,21,533,598,595
Average turn around time,354.6,,,,,
