Job ID,Arrival,Burst,Priority,Deadline,Start,End,Turn Around
0,0,76,1,3,0,76,76
4,1,72,1,2,76,148,147
1,1,42,1,10,148,190,189
2,1,96,1,19,190,286,285
3,1,84,2,7,286,370,369
6,2,46,3,4,370,416,414
5,2,36,3,21,416,452,450
7,3,46,1,13,452,498,495
9,3,65,1,21,498,563,560
8,3,35,3,7,563,598,595
Average turn around time,358.0,,,,,
